66
114
11
:/maps_backgrounds/img/background.png
0000000000000000000000000000000000000000000000000000000000000000000000000000000000000000000000000000000000000000000
0000000000000000000000000000000000cc0cc00000000000000000000000000000000p0000000cccccc000000000000000000000000000000
00000000000000c0000000000000000000ccccc0000000000000000000000000000000000000000cccccc000000000000000000000000000000
0000m000000000c00000000000000000000ccc000000000000000g0000000000000000000000000444444000000000000000000000000000000
00000000000000c00000000cc00000000000c000000000000000000000000000000000000000000000000000000000000040000000000000000
0000000000s00000000000c0000s000000000000000000ccc000000000000000000000000002220000t00000000000000440000000000030000
0000000000q000q0000cc000700000000002220000000c000c000000000000000000f0000002220000000000000000004440000000000000000
000000000000000000c000000000000000000000000000000000000000000p0000q0q0q00000000000000000000000044440000000000000000
00000000g00000000000000f0000000S00000000000000fff000000000000000000000000000000000000000000000444440000000000000000
00000f0000000f0000008000000000000000000000008000000000000000000000000000000000000000000s000004444440000000000000000
9000000000000000000000000000000000000000000000000000000000000000000000000000000000000000000000000000000000000000000
