66
75
11
:/maps_backgrounds/img/background.png
000000000000000000000000000000000000000000000000000000000000000000000000000
0m00000000000000000000000c0c0c0c00000cc0cc000000000000000000000000000000000
0000000000000000000000000c0c0c0c00000c0c0c000000000000000000000000000000000
0000000000000000000000000ccc0c0c000000c0c00000000000000f0000000000000000000
000000000000s000000000000c0c0c0c0000000c00000000000000f6f000000000000000000
0000000000002000000000000c0c0c000000000s00000000000000666000000000000030000
00000000000000002222220000q00q0c0000070000000000000006666600000000000000000
0000022q22000t0000000000000000000000000000000000000066666660000000000000000
000000000000000000000000000000000000000000000000000666666666000000000000000
0000s00000000f000f00000sf0000ff00008000000000f00006666666666600000000000000
900000000000000000000000000000000000000000000000000000000000000000000000000
